Sample_ID	index	index2	BC
Fibroblast_1	TTCCGTTC	CCATCCAA	TTCCGTTCCCATCCAA
Fibroblast_2	TTAGGCCA	CCATCCAA	TTAGGCCACCATCCAA
Fibroblast_3	TGTGCCTT	CCATCCAA	TGTGCCTTCCATCCAA
Fibroblast_4	CGCAAGAA	CCATCCAA	CGCAAGAACCATCCAA
Fibroblast_5	GACTGTGT	CCATCCAA	GACTGTGTCCATCCAA
Fibroblast_6	TCGTAGAC	CCATCCAA	TCGTAGACCCATCCAA
Fibroblast_7	TTACCTGC	CCATCCAA	TTACCTGCCCATCCAA
Fibroblast_8	TCCGTAAG	CCATCCAA	TCCGTAAGCCATCCAA
Fibroblast_9	CACCTAAC	CCATCCAA	CACCTAACCCATCCAA
Fibroblast_10	TTGTCGTG	CCATCCAA	TTGTCGTGCCATCCAA
Fibroblast_11	TACCGTCT	CCATCCAA	TACCGTCTCCATCCAA
Fibroblast_17	GGAGAGTT	CCATCCAA	GGAGAGTTCCATCCAA
Fibroblast_18	CTCAACAG	CCATCCAA	CTCAACAGCCATCCAA
Fibroblast_19	CAACCTCA	CCATCCAA	CAACCTCACCATCCAA
Fibroblast_20	TGACCAAG	CCATCCAA	TGACCAAGCCATCCAA
Fibroblast_21	TACCGATG	CCATCCAA	TACCGATGCCATCCAA
Fibroblast_22	TTGGAACC	CCATCCAA	TTGGAACCCCATCCAA
Fibroblast_23	GGTCTCAA	CCATCCAA	GGTCTCAACCATCCAA
Fibroblast_24	TCCTTGCT	CCATCCAA	TCCTTGCTCCATCCAA
Fibroblast_25	TTCCGTTC	CCACATAG	TTCCGTTCCCACATAG
Fibroblast_26	TTAGGCCA	CCACATAG	TTAGGCCACCACATAG
Fibroblast_27	TGTGCCTT	CCACATAG	TGTGCCTTCCACATAG
Fibroblast_28	CGCAAGAA	CCACATAG	CGCAAGAACCACATAG
Fibroblast_29	GACTGTGT	CCACATAG	GACTGTGTCCACATAG
Fibroblast_30	TCGTAGAC	CCACATAG	TCGTAGACCCACATAG
Fibroblast_31	TTACCTGC	CCACATAG	TTACCTGCCCACATAG
Fibroblast_32	TCCGTAAG	CCACATAG	TCCGTAAGCCACATAG
Fibroblast_33	CACCTAAC	CCACATAG	CACCTAACCCACATAG
Fibroblast_34	TTGTCGTG	CCACATAG	TTGTCGTGCCACATAG
Fibroblast_35	TACCGTCT	CCACATAG	TACCGTCTCCACATAG
Fibroblast_36	ACAGGAGA	CCACATAG	ACAGGAGACCACATAG
Fibroblast_38	AAGCCGTT	CCACATAG	AAGCCGTTCCACATAG
Fibroblast_40	AAGAGACG	CCACATAG	AAGAGACGCCACATAG
Fibroblast_41	GGAGAGTT	CCACATAG	GGAGAGTTCCACATAG
Fibroblast_42	CTCAACAG	CCACATAG	CTCAACAGCCACATAG
Fibroblast_43	CAACCTCA	CCACATAG	CAACCTCACCACATAG
Fibroblast_44	TGACCAAG	CCACATAG	TGACCAAGCCACATAG
Fibroblast_45	TACCGATG	CCACATAG	TACCGATGCCACATAG
Fibroblast_46	TTGGAACC	CCACATAG	TTGGAACCCCACATAG
Fibroblast_47	GGTCTCAA	CCACATAG	GGTCTCAACCACATAG
Fibroblast_48	TCCTTGCT	CCACATAG	TCCTTGCTCCACATAG
Fibroblast_49	TTCCGTTC	CCAATCCT	TTCCGTTCCCAATCCT
Fibroblast_50	TTAGGCCA	CCAATCCT	TTAGGCCACCAATCCT
Fibroblast_51	TGTGCCTT	CCAATCCT	TGTGCCTTCCAATCCT
Fibroblast_52	CGCAAGAA	CCAATCCT	CGCAAGAACCAATCCT
Fibroblast_53	GACTGTGT	CCAATCCT	GACTGTGTCCAATCCT
Fibroblast_54	TCGTAGAC	CCAATCCT	TCGTAGACCCAATCCT
Fibroblast_55	TTACCTGC	CCAATCCT	TTACCTGCCCAATCCT
Fibroblast_56	TCCGTAAG	CCAATCCT	TCCGTAAGCCAATCCT
Fibroblast_57	CACCTAAC	CCAATCCT	CACCTAACCCAATCCT
Fibroblast_58	TTGTCGTG	CCAATCCT	TTGTCGTGCCAATCCT
Fibroblast_59	TACCGTCT	CCAATCCT	TACCGTCTCCAATCCT
Fibroblast_60	ACAGGAGA	CCAATCCT	ACAGGAGACCAATCCT
Fibroblast_61	TCCAAGTC	CCAATCCT	TCCAAGTCCCAATCCT
Fibroblast_62	AAGCCGTT	CCAATCCT	AAGCCGTTCCAATCCT
Fibroblast_63	GCATGTCT	CCAATCCT	GCATGTCTCCAATCCT
Fibroblast_64	AAGAGACG	CCAATCCT	AAGAGACGCCAATCCT
Fibroblast_65	GGAGAGTT	CCAATCCT	GGAGAGTTCCAATCCT
Fibroblast_66	CTCAACAG	CCAATCCT	CTCAACAGCCAATCCT
Fibroblast_67	CAACCTCA	CCAATCCT	CAACCTCACCAATCCT
Fibroblast_68	TGACCAAG	CCAATCCT	TGACCAAGCCAATCCT
Fibroblast_69	TACCGATG	CCAATCCT	TACCGATGCCAATCCT
Fibroblast_70	TTGGAACC	CCAATCCT	TTGGAACCCCAATCCT
Fibroblast_71	GGTCTCAA	CCAATCCT	GGTCTCAACCAATCCT
Fibroblast_72	TCCTTGCT	CCAATCCT	TCCTTGCTCCAATCCT
Fibroblast_73	TTCCGTTC	CGGTTGTT	TTCCGTTCCGGTTGTT
Fibroblast_74	TTAGGCCA	CGGTTGTT	TTAGGCCACGGTTGTT
Fibroblast_75	TGTGCCTT	CGGTTGTT	TGTGCCTTCGGTTGTT
Fibroblast_76	CGCAAGAA	CGGTTGTT	CGCAAGAACGGTTGTT
Fibroblast_77	GACTGTGT	CGGTTGTT	GACTGTGTCGGTTGTT
Fibroblast_78	TCGTAGAC	CGGTTGTT	TCGTAGACCGGTTGTT
Fibroblast_79	TTACCTGC	CGGTTGTT	TTACCTGCCGGTTGTT
Fibroblast_80	TCCGTAAG	CGGTTGTT	TCCGTAAGCGGTTGTT
Fibroblast_81	CACCTAAC	CGGTTGTT	CACCTAACCGGTTGTT
Fibroblast_82	TTGTCGTG	CGGTTGTT	TTGTCGTGCGGTTGTT
Fibroblast_83	TACCGTCT	CGGTTGTT	TACCGTCTCGGTTGTT
Fibroblast_84	ACAGGAGA	CGGTTGTT	ACAGGAGACGGTTGTT
Fibroblast_85	TCCAAGTC	CGGTTGTT	TCCAAGTCCGGTTGTT
Fibroblast_86	AAGCCGTT	CGGTTGTT	AAGCCGTTCGGTTGTT
Fibroblast_87	GCATGTCT	CGGTTGTT	GCATGTCTCGGTTGTT
Fibroblast_88	AAGAGACG	CGGTTGTT	AAGAGACGCGGTTGTT
Fibroblast_89	GGAGAGTT	CGGTTGTT	GGAGAGTTCGGTTGTT
Fibroblast_90	CTCAACAG	CGGTTGTT	CTCAACAGCGGTTGTT
Fibroblast_91	CAACCTCA	CGGTTGTT	CAACCTCACGGTTGTT
Fibroblast_92	TGACCAAG	CGGTTGTT	TGACCAAGCGGTTGTT
Fibroblast_93	TACCGATG	CGGTTGTT	TACCGATGCGGTTGTT
Fibroblast_94	TTGGAACC	CGGTTGTT	TTGGAACCCGGTTGTT
Fibroblast_95	GGTCTCAA	CGGTTGTT	GGTCTCAACGGTTGTT
Fibroblast_96	TCCTTGCT	CGGTTGTT	TCCTTGCTCGGTTGTT
Fibroblast_97	TTCCGTTC	CGATACTG	TTCCGTTCCGATACTG
Fibroblast_98	TTAGGCCA	CGATACTG	TTAGGCCACGATACTG
Fibroblast_99	TGTGCCTT	CGATACTG	TGTGCCTTCGATACTG
Fibroblast_100	CGCAAGAA	CGATACTG	CGCAAGAACGATACTG
Fibroblast_101	GACTGTGT	CGATACTG	GACTGTGTCGATACTG
Fibroblast_102	TCGTAGAC	CGATACTG	TCGTAGACCGATACTG
Fibroblast_103	TTACCTGC	CGATACTG	TTACCTGCCGATACTG
Fibroblast_104	TCCGTAAG	CGATACTG	TCCGTAAGCGATACTG
Fibroblast_105	CACCTAAC	CGATACTG	CACCTAACCGATACTG
Fibroblast_106	TTGTCGTG	CGATACTG	TTGTCGTGCGATACTG
Fibroblast_107	TACCGTCT	CGATACTG	TACCGTCTCGATACTG
Fibroblast_108	ACAGGAGA	CGATACTG	ACAGGAGACGATACTG
Fibroblast_109	TCCAAGTC	CGATACTG	TCCAAGTCCGATACTG
Fibroblast_110	AAGCCGTT	CGATACTG	AAGCCGTTCGATACTG
Fibroblast_111	GCATGTCT	CGATACTG	GCATGTCTCGATACTG
Fibroblast_112	AAGAGACG	CGATACTG	AAGAGACGCGATACTG
Fibroblast_113	GGAGAGTT	CGATACTG	GGAGAGTTCGATACTG
Fibroblast_114	CTCAACAG	CGATACTG	CTCAACAGCGATACTG
Fibroblast_115	CAACCTCA	CGATACTG	CAACCTCACGATACTG
Fibroblast_116	TGACCAAG	CGATACTG	TGACCAAGCGATACTG
Fibroblast_117	TACCGATG	CGATACTG	TACCGATGCGATACTG
Fibroblast_118	TTGGAACC	CGATACTG	TTGGAACCCGATACTG
Fibroblast_119	GGTCTCAA	CGATACTG	GGTCTCAACGATACTG
Fibroblast_120	TCCTTGCT	CGATACTG	TCCTTGCTCGATACTG
Fibroblast_121	TTCCGTTC	CGAATTGG	TTCCGTTCCGAATTGG
Fibroblast_122	TTAGGCCA	CGAATTGG	TTAGGCCACGAATTGG
Fibroblast_123	TGTGCCTT	CGAATTGG	TGTGCCTTCGAATTGG
Fibroblast_124	CGCAAGAA	CGAATTGG	CGCAAGAACGAATTGG
Fibroblast_125	GACTGTGT	CGAATTGG	GACTGTGTCGAATTGG
Fibroblast_126	TCGTAGAC	CGAATTGG	TCGTAGACCGAATTGG
Fibroblast_127	TTACCTGC	CGAATTGG	TTACCTGCCGAATTGG
Fibroblast_128	TCCGTAAG	CGAATTGG	TCCGTAAGCGAATTGG
Fibroblast_129	CACCTAAC	CGAATTGG	CACCTAACCGAATTGG
Fibroblast_130	TTGTCGTG	CGAATTGG	TTGTCGTGCGAATTGG
Fibroblast_131	TACCGTCT	CGAATTGG	TACCGTCTCGAATTGG
Fibroblast_132	ACAGGAGA	CGAATTGG	ACAGGAGACGAATTGG
Fibroblast_133	TCCAAGTC	CGAATTGG	TCCAAGTCCGAATTGG
Fibroblast_134	AAGCCGTT	CGAATTGG	AAGCCGTTCGAATTGG
Fibroblast_135	GCATGTCT	CGAATTGG	GCATGTCTCGAATTGG
Fibroblast_136	AAGAGACG	CGAATTGG	AAGAGACGCGAATTGG
Fibroblast_137	GGAGAGTT	CGAATTGG	GGAGAGTTCGAATTGG
Fibroblast_138	CTCAACAG	CGAATTGG	CTCAACAGCGAATTGG
Fibroblast_139	CAACCTCA	CGAATTGG	CAACCTCACGAATTGG
Fibroblast_140	TGACCAAG	CGAATTGG	TGACCAAGCGAATTGG
Fibroblast_141	TACCGATG	CGAATTGG	TACCGATGCGAATTGG
Fibroblast_142	TTGGAACC	CGAATTGG	TTGGAACCCGAATTGG
Fibroblast_143	GGTCTCAA	CGAATTGG	GGTCTCAACGAATTGG
Fibroblast_144	TCCTTGCT	CGAATTGG	TCCTTGCTCGAATTGG
Fibroblast_145	TTCCGTTC	CATGCTTC	TTCCGTTCCATGCTTC
Fibroblast_146	TTAGGCCA	CATGCTTC	TTAGGCCACATGCTTC
Fibroblast_147	TGTGCCTT	CATGCTTC	TGTGCCTTCATGCTTC
Fibroblast_148	CGCAAGAA	CATGCTTC	CGCAAGAACATGCTTC
Fibroblast_149	GACTGTGT	CATGCTTC	GACTGTGTCATGCTTC
Fibroblast_150	TCGTAGAC	CATGCTTC	TCGTAGACCATGCTTC
Fibroblast_151	TTACCTGC	CATGCTTC	TTACCTGCCATGCTTC
Fibroblast_152	TCCGTAAG	CATGCTTC	TCCGTAAGCATGCTTC
Fibroblast_153	CACCTAAC	CATGCTTC	CACCTAACCATGCTTC
Fibroblast_154	TTGTCGTG	CATGCTTC	TTGTCGTGCATGCTTC
Fibroblast_155	TACCGTCT	CATGCTTC	TACCGTCTCATGCTTC
Fibroblast_156	ACAGGAGA	CATGCTTC	ACAGGAGACATGCTTC
Fibroblast_157	TCCAAGTC	CATGCTTC	TCCAAGTCCATGCTTC
Fibroblast_158	AAGCCGTT	CATGCTTC	AAGCCGTTCATGCTTC
Fibroblast_159	GCATGTCT	CATGCTTC	GCATGTCTCATGCTTC
Fibroblast_160	AAGAGACG	CATGCTTC	AAGAGACGCATGCTTC
Fibroblast_161	GGAGAGTT	CATGCTTC	GGAGAGTTCATGCTTC
Fibroblast_162	CTCAACAG	CATGCTTC	CTCAACAGCATGCTTC
Fibroblast_163	CAACCTCA	CATGCTTC	CAACCTCACATGCTTC
Fibroblast_164	TGACCAAG	CATGCTTC	TGACCAAGCATGCTTC
Fibroblast_165	TACCGATG	CATGCTTC	TACCGATGCATGCTTC
Fibroblast_166	TTGGAACC	CATGCTTC	TTGGAACCCATGCTTC
Fibroblast_167	GGTCTCAA	CATGCTTC	GGTCTCAACATGCTTC
Fibroblast_168	TCCTTGCT	CATGCTTC	TCCTTGCTCATGCTTC
Fibroblast_169	TTCCGTTC	CAGATTCG	TTCCGTTCCAGATTCG
Fibroblast_170	TTAGGCCA	CAGATTCG	TTAGGCCACAGATTCG
Fibroblast_171	TGTGCCTT	CAGATTCG	TGTGCCTTCAGATTCG
Fibroblast_172	CGCAAGAA	CAGATTCG	CGCAAGAACAGATTCG
Fibroblast_173	GACTGTGT	CAGATTCG	GACTGTGTCAGATTCG
Fibroblast_174	TCGTAGAC	CAGATTCG	TCGTAGACCAGATTCG
Fibroblast_175	TTACCTGC	CAGATTCG	TTACCTGCCAGATTCG
Fibroblast_176	TCCGTAAG	CAGATTCG	TCCGTAAGCAGATTCG
Fibroblast_177	CACCTAAC	CAGATTCG	CACCTAACCAGATTCG
Fibroblast_178	TTGTCGTG	CAGATTCG	TTGTCGTGCAGATTCG
Fibroblast_179	TACCGTCT	CAGATTCG	TACCGTCTCAGATTCG
Fibroblast_180	ACAGGAGA	CAGATTCG	ACAGGAGACAGATTCG
Fibroblast_181	TCCAAGTC	CAGATTCG	TCCAAGTCCAGATTCG
Fibroblast_182	AAGCCGTT	CAGATTCG	AAGCCGTTCAGATTCG
Fibroblast_183	GCATGTCT	CAGATTCG	GCATGTCTCAGATTCG
Fibroblast_184	AAGAGACG	CAGATTCG	AAGAGACGCAGATTCG
Fibroblast_185	GGAGAGTT	CAGATTCG	GGAGAGTTCAGATTCG
Fibroblast_186	CTCAACAG	CAGATTCG	CTCAACAGCAGATTCG
Fibroblast_187	CAACCTCA	CAGATTCG	CAACCTCACAGATTCG
Fibroblast_188	TGACCAAG	CAGATTCG	TGACCAAGCAGATTCG
Fibroblast_189	TACCGATG	CAGATTCG	TACCGATGCAGATTCG
Fibroblast_190	TTGGAACC	CAGATTCG	TTGGAACCCAGATTCG
Fibroblast_191	GGTCTCAA	CAGATTCG	GGTCTCAACAGATTCG
Fibroblast_192	TCCTTGCT	CAGATTCG	TCCTTGCTCAGATTCG
